##############################
#                            #
# X                          #
#           P                #
#                            #
#########                    #
#   O ###                    #
#     ###                    #
#     ###                    #
#                            #
#                    ###     #
#                    ###     #
##############################
